1111
1P01
1C01
10E1
1001

1111
