1111111111111111111111111111111111111
1000000000000000000000000000000000001
1000000000000000000000000000E00000001
100000P000000000000000000000000000001
100000000000000000000C000000000000001
100000C000000000000000000000C00000001
1000000000000000000000000000000000001
1000000000000000000000000000000000001
1111111111111111111111111111111111111
