1111111111111111
1111111111P11111
11C1111111111111
1111111111C11111
1000000000000001
1111111111111111
