111111111111111111111
100C00001100001111111
100011000000000000011
1E0011000000000000001
100000000P000000000a1
1000000000000000C0001
111111111111111111111
